deasphalt	V;PRS;NOM-3;NOM-SG	deasphalts
underman	V;V.PTCP;PRS	undermanned
bet	V;PRS;NOM-3;NOM-SG	bets
gyve	V;V.PTCP;PRS	gyving
corporealise	V;V.PTCP;PRS	corporealising
shudder	V;PRS;NOM-3;NOM-SG	shudders
relax	V;PRS;NOM-3;NOM-SG	relaxes
roin	V;PRS;NOM-3;NOM-SG	roins
parachute	V;PST	parachuted
faceplant	V;NFIN	faceplant
cere	V;V.PTCP;PRS	cering
sedentarize	V;PRS;NOM-3;NOM-SG	sedentarizes
arcticize	V;V.PTCP;PST	arcticized
peripheralize	V;V.PTCP;PRS	peripheralizing
rechain	V;PST	rechained
wringle-wrangle	V;V.PTCP;PST	wringle-wrangled
English	V;V.PTCP;PST	Englished
regress	V;V.PTCP;PST	regressed
humble	V;PST	humbled
forhunger	V;V.PTCP;PST	forhungered
urbanise	V;V.PTCP;PST	urbanised
clock	V;PRS;NOM-3;NOM-SG	clocks
mace	V;V.PTCP;PST	maced
astony	V;NFIN	astony
anagram	V;NFIN	anagram
antioxidize	V;NFIN	antioxidize
thee	V;PST	theed
accommodate	V;PRS;NOM-3;NOM-SG	accommodates
parody	V;V.PTCP;PST	parodied
fiddlefart	V;NFIN	fiddlefart
quicksave	V;V.PTCP;PST	quicksaved
assaile	V;PRS;NOM-3;NOM-SG	assailes
supercool	V;NFIN	supercool
fook	V;V.PTCP;PST	fooked
recut	V;PST	recut
side-foot	V;V.PTCP;PRS	side-footing
transpare	V;PRS;NOM-3;NOM-SG	transpares
fountain	V;V.PTCP;PST	fountained
nodulate	V;V.PTCP;PRS	nodulating
forthdraw	V;PRS;NOM-3;NOM-SG	forthdraws
flash	V;PST	flashed
respect	V;V.PTCP;PST	respected
intensify	V;V.PTCP;PST	intensified
ammo	V;PRS;NOM-3;NOM-SG	ammos
protocolize	V;V.PTCP;PRS	protocolizing
tweedle	V;V.PTCP;PST	tweedled
circummure	V;PRS;NOM-3;NOM-SG	circummures
embolden	V;V.PTCP;PST	emboldened
itinerate	V;NFIN	itinerate
counteroffer	V;NFIN	counteroffer
misregard	V;PRS;NOM-3;NOM-SG	misregards
slabber	V;PST	slabbered
soap	V;PRS;NOM-3;NOM-SG	soaps
emulsify	V;V.PTCP;PST	emulsified
killfile	V;V.PTCP;PRS	killfiling
ingrain	V;PRS;NOM-3;NOM-SG	ingrains
upgaze	V;NFIN	upgaze
skilder	V;PST	skildered
snarfle	V;V.PTCP;PRS	snarfling
photoacclimate	V;V.PTCP;PRS	photoacclimating
uproot	V;PST	uprooted
autograft	V;NFIN	autograft
scald	V;NFIN	scald
gel	V;PST	gelled
postulate	V;V.PTCP;PST	postulated
promo	V;NFIN	promo
ditch	V;PRS;NOM-3;NOM-SG	ditches
overcriticize	V;V.PTCP;PRS	overcriticizing
toshake	V;NFIN	toshake
overshape	V;PRS;NOM-3;NOM-SG	overshapes
caddy	V;PST	caddied
redirect	V;PRS;NOM-3;NOM-SG	redirects
solemnify	V;NFIN	solemnify
come	V;PRS;NOM-3;NOM-SG	comes
discerp	V;V.PTCP;PRS	discerping
stonify	V;PST	stonified
photoacclimate	V;PST	photoacclimated
overlap	V;V.PTCP;PST	overlapped
self-injure	V;V.PTCP;PST	self-injured
assecure	V;PRS;NOM-3;NOM-SG	assecures
rightsize	V;NFIN	rightsize
becast	V;NFIN	becast
legitimatize	V;PRS;NOM-3;NOM-SG	legitimatizes
variate	V;PST	variated
unmatch	V;NFIN	unmatch
photoinject	V;V.PTCP;PRS	photoinjecting
display	V;V.PTCP;PRS	displaying
dishonour	V;V.PTCP;PST	dishonoured
slide	V;V.PTCP;PST	slid
forepay	V;V.PTCP;PST	forepaid
addulce	V;NFIN	addulce
envermeil	V;V.PTCP;PRS	envermeiling
temporalise	V;V.PTCP;PST	temporalised
torve	V;PST	torved
fortravel	V;PRS;NOM-3;NOM-SG	fortravels
potentize	V;V.PTCP;PRS	potentizing
spokeshave	V;V.PTCP;PRS	spokeshaving
newfront	V;PST	newfronted
unmake	V;PST	unmade
omnify	V;PST	omnified
resoun	V;PRS;NOM-3;NOM-SG	resouns
illuminize	V;PST	illuminized
toruffle	V;NFIN	toruffle
yarn	V;PST	yarned
Wikipedia	V;V.PTCP;PST	Wikipediaed
patriate	V;PRS;NOM-3;NOM-SG	patriates
spittle	V;V.PTCP;PRS	spittling
cumshaw	V;V.PTCP;PST	cumshawed
steem	V;PRS;NOM-3;NOM-SG	steems
unburden	V;V.PTCP;PRS	unburdening
exeunt	V;V.PTCP;PST	exeunted
rattoon	V;V.PTCP;PRS	rattooning
benumb	V;PST	benumbed
scarify	V;PRS;NOM-3;NOM-SG	scarifies
overborrow	V;PRS;NOM-3;NOM-SG	overborrows
underpitch	V;PST	underpitched
trindle	V;V.PTCP;PRS	trindling
envowel	V;V.PTCP;PST	envowelled
smoor	V;V.PTCP;PRS	smooring
productize	V;PRS;NOM-3;NOM-SG	productizes
scrutinize	V;PRS;NOM-3;NOM-SG	scrutinizes
outcharm	V;NFIN	outcharm
promo	V;PRS;NOM-3;NOM-SG	promos
noon	V;PRS;NOM-3;NOM-SG	noons
Darwinize	V;PST	Darwinized
telecommute	V;V.PTCP;PRS	telecommuting
tend	V;V.PTCP;PST	tended
misinstruct	V;PRS;NOM-3;NOM-SG	misinstructs
resand	V;PRS;NOM-3;NOM-SG	resands
waterfall	V;PRS;NOM-3;NOM-SG	waterfalls
architect	V;PRS;NOM-3;NOM-SG	architects
forscald	V;PST	forscalded
downsize	V;V.PTCP;PRS	downsizing
tramble	V;PST	trambled
untongue	V;NFIN	untongue
earn	V;PST	earned
casevac	V;PRS;NOM-3;NOM-SG	casevacs
trampoline	V;PST	trampolined
halal	V;PST	halaled
aurify	V;V.PTCP;PST	aurified
blather	V;V.PTCP;PST	blathered
buccaneer	V;V.PTCP;PRS	buccaneering
aggroup	V;PRS;NOM-3;NOM-SG	aggroups
reperforate	V;V.PTCP;PRS	reperforating
aestuate	V;PRS;NOM-3;NOM-SG	aestuates
infant	V;NFIN	infant
goosestep	V;NFIN	goosestep
idolize	V;NFIN	idolize
compassion	V;V.PTCP;PST	compassioned
emaculate	V;PST	emaculated
nickname	V;V.PTCP;PST	nicknamed
interblend	V;V.PTCP;PST	interblent
blackhole	V;NFIN	blackhole
dishaunt	V;PST	dishaunted
digladiate	V;V.PTCP;PST	digladiated
halal	V;NFIN	halal
superconduct	V;NFIN	superconduct
disheir	V;V.PTCP;PRS	disheiring
impassion	V;PST	impassioned
ionise	V;PRS;NOM-3;NOM-SG	ionises
repressurise	V;PRS;NOM-3;NOM-SG	repressurises
mesh	V;PST	meshed
silken	V;PRS;NOM-3;NOM-SG	silkens
route	V;NFIN	route
consolidate	V;NFIN	consolidate
angel	V;NFIN	angel
liquify	V;NFIN	liquify
peercast	V;NFIN	peercast
naturalise	V;V.PTCP;PST	naturalised
queef	V;PST	queefed
emphasize	V;NFIN	emphasize
hardwire	V;V.PTCP;PST	hardwired
communifake	V;PST	communifaked
guffaw	V;V.PTCP;PST	guffawed
spawn	V;NFIN	spawn
exulcerate	V;V.PTCP;PRS	exulcerating
witticise	V;PST	witticised
recapitalise	V;PRS;NOM-3;NOM-SG	recapitalises
ambuscade	V;PST	ambuscaded
foregrasp	V;PRS;NOM-3;NOM-SG	foregrasps
aguise	V;PST	aguised
piqueer	V;NFIN	piqueer
demetallize	V;V.PTCP;PRS	demetallizing
autoregulate	V;PRS;NOM-3;NOM-SG	autoregulates
direct	V;NFIN	direct
reguard	V;V.PTCP;PRS	reguarding
snoozle	V;V.PTCP;PST	snoozling
rawk	V;V.PTCP;PST	rawked
tinkle	V;NFIN	tinkle
flummox	V;V.PTCP;PST	flummoxed
squir	V;PRS;NOM-3;NOM-SG	squirs
remit	V;NFIN	remit
force-feed	V;V.PTCP;PRS	force-feeding
submodify	V;V.PTCP;PRS	submodifying
astony	V;PRS;NOM-3;NOM-SG	astonies
pierce	V;V.PTCP;PST	pierced
unhide	V;PST	unhid
meld	V;PRS;NOM-3;NOM-SG	melds
ravish	V;PRS;NOM-3;NOM-SG	ravishes
berm	V;V.PTCP;PRS	berming
jeopardize	V;PRS;NOM-3;NOM-SG	jeopardizes
cross-foster	V;PRS;NOM-3;NOM-SG	cross-fosters
fantasy	V;NFIN	fantasy
befie	V;NFIN	befie
lap	V;NFIN	lap
bleb	V;V.PTCP;PRS	blebbing
bonnet	V;PRS;NOM-3;NOM-SG	bonnets
libate	V;PST	libated
jasperize	V;V.PTCP;PST	jasperized
devvel	V;PST	devvelled
uncork	V;V.PTCP;PST	uncorked
gravitate	V;V.PTCP;PST	gravitated
custom	V;PST	customed
abvolate	V;V.PTCP;PST	abvolated
unbrace	V;PRS;NOM-3;NOM-SG	unbraces
backstab	V;PRS;NOM-3;NOM-SG	backstabs
upzone	V;NFIN	upzone
fingertip	V;V.PTCP;PRS	fingertipping
underpot	V;V.PTCP;PRS	underpotting
restrain	V;PST	restrained
dissocialize	V;V.PTCP;PRS	dissocializing
soliloquise	V;V.PTCP;PST	soliloquised
backcomb	V;V.PTCP;PST	backcombed
pamp	V;PRS;NOM-3;NOM-SG	pamps
epoxidize	V;NFIN	epoxidize
normalize	V;V.PTCP;PRS	normalizing
chivvy	V;V.PTCP;PST	chivvied
exhibit	V;V.PTCP;PST	exhibited
unerase	V;V.PTCP;PST	unerased
rechamber	V;PST	rechambered
valet	V;V.PTCP;PRS	valeting
engulph	V;V.PTCP;PST	engulphed
shmear	V;PST	shmeared
coalesce	V;V.PTCP;PST	coalesced
perispome	V;V.PTCP;PRS	perispoming
island-hop	V;PRS;NOM-3;NOM-SG	island-hops
smirch	V;PRS;NOM-3;NOM-SG	smirches
skinch	V;NFIN	skinch
agriculturise	V;V.PTCP;PST	agriculturised
minge	V;NFIN	minge
poof	V;PST	poofed
infant	V;PST	infanted
aim	V;PST	aimed
detraditionalise	V;PRS;NOM-3;NOM-SG	detraditionalises
equivalate	V;V.PTCP;PST	equivalated
miscognize	V;NFIN	miscognize
uncharge	V;V.PTCP;PRS	uncharging
debar	V;V.PTCP;PST	debarred
mope	V;V.PTCP;PRS	moping
reanneal	V;V.PTCP;PST	reannealed
fauch	V;PST	fauched
humblebrag	V;PRS;NOM-3;NOM-SG	humblebrags
chatter	V;PST	chattered
par	V;NFIN	par
torive	V;V.PTCP;PRS	toriving
synch	V;V.PTCP;PRS	synching
scrooch	V;PST	scrooched
sweeten	V;V.PTCP;PRS	sweetening
fratch	V;PST	fratched
bewell	V;V.PTCP;PST	bewelled
bar	V;NFIN	bar
burl	V;V.PTCP;PRS	burling
dashboard	V;V.PTCP;PST	dashboarded
disparkle	V;PRS;NOM-3;NOM-SG	disparkles
disgest	V;PRS;NOM-3;NOM-SG	disgests
teamkill	V;V.PTCP;PST	teamkilled
fauch	V;PRS;NOM-3;NOM-SG	fauches
hypertextualize	V;V.PTCP;PRS	hypertextualizing
misrate	V;PST	misrated
wattle	V;PST	wattled
snigger	V;PRS;NOM-3;NOM-SG	sniggers
overeye	V;PST	overeyed
moot	V;V.PTCP;PST	mooted
move	V;PST	moved
consist	V;PRS;NOM-3;NOM-SG	consists
interlope	V;NFIN	interlope
free	V;V.PTCP;PRS	freeing
wig	V;NFIN	wig
seise	V;NFIN	seise
deblock	V;V.PTCP;PST	deblocked
unpunctuate	V;PRS;NOM-3;NOM-SG	unpunctuates
trampoline	V;V.PTCP;PST	trampolined
coalesce	V;PST	coalesced
meed	V;NFIN	meed
bait	V;PST	baited
preconform	V;NFIN	preconform
blore	V;PRS;NOM-3;NOM-SG	blores
parameterise	V;V.PTCP;PST	parameterised
denib	V;PRS;NOM-3;NOM-SG	denibs
criticise	V;V.PTCP;PRS	criticising
muddle	V;V.PTCP;PRS	muddling
contaminate	V;NFIN	contaminate
upgather	V;V.PTCP;PRS	upgathering
pamp	V;PST	pamped
bonnet	V;V.PTCP;PST	bonneted
underreach	V;PST	underreached
traitor	V;V.PTCP;PRS	traitoring
forebite	V;NFIN	forebite
uncurse	V;V.PTCP;PRS	uncursing
brother	V;V.PTCP;PST	brothered
hunker	V;PRS;NOM-3;NOM-SG	hunkers
overborrow	V;V.PTCP;PST	overborrowed
ironize	V;V.PTCP;PRS	ironizing
uncompress	V;PRS;NOM-3;NOM-SG	uncompresses
synch	V;PST	synched
consolidate	V;V.PTCP;PRS	consolidating
rereport	V;V.PTCP;PST	rereported
incapacitate	V;V.PTCP;PST	incapacitated
colport	V;PST	colported
bedhop	V;V.PTCP;PRS	bedhopping
irreconcile	V;PRS;NOM-3;NOM-SG	irreconciles
addulce	V;PRS;NOM-3;NOM-SG	addulces
casevac	V;V.PTCP;PRS	casevacking
productize	V;V.PTCP;PRS	productizing
contemn	V;PRS;NOM-3;NOM-SG	contemns
bangtail	V;V.PTCP;PRS	bangtailing
empeople	V;PRS;NOM-3;NOM-SG	empeoples
gambol	V;NFIN	gambol
upcoil	V;V.PTCP;PRS	upcoiling
questionnaire	V;NFIN	questionnaire
disapparel	V;PST	disapparelled
content	V;NFIN	content
remit	V;PRS;NOM-3;NOM-SG	remits
dishaunt	V;PRS;NOM-3;NOM-SG	dishaunts
garotte	V;V.PTCP;PST	garotted
difficult	V;V.PTCP;PST	difficulted
clown	V;NFIN	clown
recommission	V;V.PTCP;PST	recommissioned
pamphletize	V;PRS;NOM-3;NOM-SG	pamphletizes
thumbshot	V;V.PTCP;PST	thumbshotted
inviscerate	V;PST	inviscerated
traitor	V;PST	traitored
guffaw	V;V.PTCP;PRS	guffawing
saint	V;PST	sainted
lofe	V;NFIN	lofe
circummure	V;V.PTCP;PRS	circummuring
expone	V;PST	exponed
balmify	V;PRS;NOM-3;NOM-SG	balmifies
apprentise	V;NFIN	apprentise
ache	V;V.PTCP;PST	aken
vole	V;V.PTCP;PRS	voling
maternalise	V;V.PTCP;PST	maternalised
remain	V;V.PTCP;PST	remained
pessimize	V;NFIN	pessimize
lixiviate	V;V.PTCP;PRS	lixiviating
piton	V;PRS;NOM-3;NOM-SG	pitons
bestride	V;V.PTCP;PST	bestrode
betide	V;PST	betid
mace	V;PST	maced
whang	V;PRS;NOM-3;NOM-SG	whangs
reprofile	V;V.PTCP;PRS	reprofiling
condenscend	V;V.PTCP;PRS	condenscending
gork	V;V.PTCP;PST	gorked
fess	V;V.PTCP;PRS	fessing
rift	V;V.PTCP;PRS	rifting
out-winter	V;PST	out-wintered
harvest	V;NFIN	harvest
elixate	V;PRS;NOM-3;NOM-SG	elixates
thick	V;NFIN	thick
exprobate	V;V.PTCP;PRS	exprobating
lasso	V;PST	lassoed
enucleate	V;V.PTCP;PST	enucleated
glaum	V;PST	glaumed
outmanœuvre	V;V.PTCP;PST	outmanœuvred
brooch	V;PST	brooched
infamize	V;PST	infamized
capacify	V;V.PTCP;PRS	capacifying
reinitialise	V;V.PTCP;PRS	reinitialising
carbonitride	V;NFIN	carbonitride
ungrab	V;PRS;NOM-3;NOM-SG	ungrabs
mope	V;NFIN	mope
forewit	V;PST	forewist
pern	V;PRS;NOM-3;NOM-SG	perns
lapper	V;PST	lappered
barter	V;NFIN	barter
misbutton	V;PRS;NOM-3;NOM-SG	misbuttons
emendate	V;PRS;NOM-3;NOM-SG	emendates
lyse	V;NFIN	lyse
unpick	V;PRS;NOM-3;NOM-SG	unpicks
kemp	V;V.PTCP;PRS	kemping
gird	V;PRS;NOM-3;NOM-SG	girds
misthread	V;V.PTCP;PRS	misthreading
citrate	V;V.PTCP;PRS	citrating
tilt	V;PRS;NOM-3;NOM-SG	tilts
vitalize	V;V.PTCP;PST	vitalized
cask	V;V.PTCP;PST	casked
gesture	V;V.PTCP;PRS	gesturing
flout	V;NFIN	flout
amay	V;PST	amayed
gemmate	V;PST	gemmated
polyubiquitinate	V;V.PTCP;PRS	polyubiquitinating
blindfold	V;NFIN	blindfold
bleeze	V;V.PTCP;PRS	bleezing
bode	V;NFIN	bode
accustomise	V;V.PTCP;PRS	accustomising
interjaculate	V;V.PTCP;PRS	interjaculating
outgeneral	V;V.PTCP;PRS	outgeneralling
shore	V;V.PTCP;PRS	shoring
rift	V;PST	rifted
desublimate	V;PRS;NOM-3;NOM-SG	desublimates
slant	V;V.PTCP;PRS	slanting
misconjecture	V;PST	misconjectured
boomerang	V;V.PTCP;PRS	boomeranging
spall	V;PST	spalled
divertise	V;PRS;NOM-3;NOM-SG	divertises
duchess	V;V.PTCP;PST	duchessed
depoetize	V;V.PTCP;PRS	depoetizing
deglamorize	V;PRS;NOM-3;NOM-SG	deglamorizes
mate	V;PST	mated
kosherize	V;V.PTCP;PRS	kosherizing
collateralize	V;V.PTCP;PST	collateralized
spotface	V;PRS;NOM-3;NOM-SG	spotfaces
wheech	V;V.PTCP;PRS	wheeching
inveigle	V;PST	inveigled
crosscontaminate	V;PRS;NOM-3;NOM-SG	crosscontaminates
expidite	V;PRS;NOM-3;NOM-SG	expidites
deglottalize	V;NFIN	deglottalize
toboggan	V;V.PTCP;PST	tobogganed
attune	V;PST	attuned
luv	V;V.PTCP;PRS	luvving
transpare	V;PST	transpared
exeunt	V;V.PTCP;PRS	exeunting
drawbore	V;V.PTCP;PRS	drawboring
jess	V;V.PTCP;PST	jessed
rechain	V;NFIN	rechain
tattoo	V;PST	tattooed
devolute	V;NFIN	devolute
beframe	V;V.PTCP;PST	beframed
glore	V;NFIN	glore
grope	V;V.PTCP;PRS	groping
betimber	V;PRS;NOM-3;NOM-SG	betimbers
reimburse	V;PST	reimbursed
reascend	V;V.PTCP;PRS	reascending
toswap	V;PRS;NOM-3;NOM-SG	toswaps
gouge	V;PST	gouged
thee	V;PRS;NOM-3;NOM-SG	thees
redon	V;PRS;NOM-3;NOM-SG	redons
teamkill	V;PRS;NOM-3;NOM-SG	teamkills
repin	V;V.PTCP;PRS	repinning
acquittance	V;PRS;NOM-3;NOM-SG	acquittances
pilgrimage	V;V.PTCP;PST	pilgrimaged
moot	V;PRS;NOM-3;NOM-SG	moots
hardcode	V;NFIN	hardcode
scud	V;PST	scudded
annumerate	V;NFIN	annumerate
prædict	V;V.PTCP;PRS	prædicting
underprescribe	V;V.PTCP;PRS	underprescribing
alligate	V;V.PTCP;PRS	alligating
bestream	V;NFIN	bestream
ormolu	V;PRS;NOM-3;NOM-SG	ormolus
unpunctuate	V;PST	unpunctuated
decolourize	V;PST	decolourized
vat	V;V.PTCP;PST	vatted
critique	V;NFIN	critique
deconfigure	V;PRS;NOM-3;NOM-SG	deconfigures
harvest	V;PRS;NOM-3;NOM-SG	harvests
incage	V;V.PTCP;PST	incaged
pirouette	V;V.PTCP;PST	pirouetted
uncommit	V;NFIN	uncommit
pollock	V;PRS;NOM-3;NOM-SG	pollocks
distract	V;V.PTCP;PST	distracted
capacify	V;PRS;NOM-3;NOM-SG	capacifies
fox	V;V.PTCP;PRS	foxing
scum	V;NFIN	scum
abnormalize	V;PST	abnormalized
dowry	V;V.PTCP;PST	dowried
superinfect	V;NFIN	superinfect
mace	V;NFIN	mace
slabber	V;V.PTCP;PRS	slabbering
redeem	V;PRS;NOM-3;NOM-SG	redeems
foreguess	V;PST	foreguessed
gack	V;V.PTCP;PST	gacked
listen	V;PRS;NOM-3;NOM-SG	listens
shroud	V;V.PTCP;PRS	shrouding
santer	V;NFIN	santer
foredoom	V;NFIN	foredoom
prioritize	V;V.PTCP;PRS	prioritizing
modernize	V;PST	modernized
unbolt	V;NFIN	unbolt
impropriate	V;NFIN	impropriate
flip-flap	V;NFIN	flip-flap
befortune	V;PST	befortuned
blether	V;PST	blethered
spin	V;NFIN	spin
overfuck	V;V.PTCP;PST	overfucked
digladiate	V;NFIN	digladiate
spill	V;V.PTCP;PST	spilt
exaggerate	V;NFIN	exaggerate
liquidize	V;PST	liquidized
jess	V;NFIN	jess
jive	V;PRS;NOM-3;NOM-SG	jives
transfect	V;PST	transfected
overmilk	V;PRS;NOM-3;NOM-SG	overmilks
disdeign	V;PST	disdeigned
retransfer	V;NFIN	retransfer
victual	V;V.PTCP;PRS	victualling
burnish	V;V.PTCP;PST	burnished
crackle	V;V.PTCP;PRS	crackling
wog	V;V.PTCP;PRS	wogging
spork	V;PRS;NOM-3;NOM-SG	sporks
underrotate	V;PRS;NOM-3;NOM-SG	underrotates
padlock	V;PST	padlocked
dovetail	V;PRS;NOM-3;NOM-SG	dovetails
dethatch	V;PRS;NOM-3;NOM-SG	dethatches
governess	V;V.PTCP;PRS	governessing
razee	V;NFIN	razee
underorder	V;V.PTCP;PST	underordered
beleap	V;V.PTCP;PRS	beleaping
shroud	V;PST	shrouded
noun	V;PRS;NOM-3;NOM-SG	nouns
pattinsonize	V;PST	pattinsonized
spritz	V;V.PTCP;PRS	spritzing
disconcur	V;PST	disconcurred
barbecue	V;NFIN	barbecue
subpœna	V;NFIN	subpœna
carbonatize	V;PST	carbonatized
gyve	V;V.PTCP;PST	gyved
clambake	V;NFIN	clambake
huxter	V;V.PTCP;PST	huxtered
bucket	V;PRS;NOM-3;NOM-SG	buckets
decurt	V;PST	decurted
brownnose	V;V.PTCP;PRS	brownnosing
reglaze	V;V.PTCP;PRS	reglazing
gargarize	V;PRS;NOM-3;NOM-SG	gargarizes
pash	V;PRS;NOM-3;NOM-SG	pashes
rechamber	V;NFIN	rechamber
pinwheel	V;V.PTCP;PST	pinwheeled
disconcur	V;PRS;NOM-3;NOM-SG	disconcurs
minge	V;PST	minged
redecorate	V;PST	redecorated
sedentarize	V;PST	sedentarized
fancy	V;V.PTCP;PRS	fancying
costen	V;V.PTCP;PRS	costening
recalk	V;V.PTCP;PST	recalked
weep	V;NFIN	weep
syllabify	V;V.PTCP;PRS	syllabifying
prelude	V;PST	preluded
corrade	V;PRS;NOM-3;NOM-SG	corrades
ironize	V;PST	ironized
incloister	V;V.PTCP;PRS	incloistering
glump	V;PST	glumped
pap	V;PST	papped
unappropriate	V;PRS;NOM-3;NOM-SG	unappropriates
Mondayize	V;V.PTCP;PST	Mondayized
superharden	V;V.PTCP;PST	superhardened
redevelop	V;V.PTCP;PRS	redeveloping
unpick	V;PST	unpicked
ambush	V;PST	ambushed
astony	V;V.PTCP;PST	astonied
gazunder	V;PST	gazundered
hem	V;V.PTCP;PST	hemmed
experimentise	V;V.PTCP;PST	experimentised
dit	V;V.PTCP;PRS	ditting
inhive	V;V.PTCP;PST	inhived
depacketize	V;PRS;NOM-3;NOM-SG	depacketizes
throe	V;V.PTCP;PRS	throeing
epoxidize	V;PRS;NOM-3;NOM-SG	epoxidizes
impaste	V;PST	impasted
lifen	V;V.PTCP;PRS	lifening
unwonder	V;NFIN	unwonder
grain	V;V.PTCP;PRS	graining
rehinge	V;PRS;NOM-3;NOM-SG	rehinges
disheir	V;PRS;NOM-3;NOM-SG	disheirs
toboggan	V;PST	tobogganed
outcharm	V;V.PTCP;PRS	outcharming
shack	V;PRS;NOM-3;NOM-SG	shacks
quadrangulate	V;PST	quadrangulated
counterseal	V;V.PTCP;PST	countersealed
exulcerate	V;PRS;NOM-3;NOM-SG	exulcerates
underprescribe	V;PST	underprescribed
patch-up	V;PRS;NOM-3;NOM-SG	patches-up
exemplifie	V;PST	exemplified
inglut	V;V.PTCP;PST	inglutted
come	V;V.PTCP;PST	come
angle	V;V.PTCP;PRS	angling
underorder	V;PRS;NOM-3;NOM-SG	underorders
adolesce	V;V.PTCP;PRS	adolescing
toboggan	V;NFIN	toboggan
decarburize	V;V.PTCP;PST	decarburized
bode	V;PRS;NOM-3;NOM-SG	bodes
skud	V;V.PTCP;PRS	skudding
overreference	V;NFIN	overreference
underwise	V;V.PTCP;PRS	underwising
lip-synch	V;PST	lip-synched
recount	V;V.PTCP;PRS	recounting
slipstream	V;NFIN	slipstream
outcharm	V;PRS;NOM-3;NOM-SG	outcharms
superhumanize	V;NFIN	superhumanize
micronise	V;PRS;NOM-3;NOM-SG	micronises
Borg	V;PST	Borged
craze	V;NFIN	craze
refollow	V;PST	refollowed
relax	V;PST	relaxed
obliterate	V;PRS;NOM-3;NOM-SG	obliterates
knife	V;V.PTCP;PRS	knifing
template	V;PRS;NOM-3;NOM-SG	templates
plash	V;PRS;NOM-3;NOM-SG	plashes
motion	V;NFIN	motion
underrotate	V;V.PTCP;PST	underrotated
shmear	V;PRS;NOM-3;NOM-SG	shmears
connex	V;NFIN	connex
paganise	V;V.PTCP;PST	paganised
pash	V;PST	pashed
exaggerate	V;PRS;NOM-3;NOM-SG	exaggerates
tympanize	V;V.PTCP;PRS	tympanizing
Mondayize	V;PRS;NOM-3;NOM-SG	Mondayizes
incloister	V;PRS;NOM-3;NOM-SG	incloisters
wair	V;NFIN	wair
spelch	V;V.PTCP;PST	spelched
entrench	V;V.PTCP;PRS	entrenching
restyle	V;V.PTCP;PST	restyled
weep	V;V.PTCP;PRS	weeping
squirrel	V;PST	squirreled
premix	V;V.PTCP;PRS	premixing
kosher	V;V.PTCP;PRS	koshering
display	V;PST	displayed
rejustify	V;V.PTCP;PST	rejustified
surpay	V;PST	surpaid
ensure	V;V.PTCP;PST	ensured
outglow	V;PST	outglowed
succuss	V;V.PTCP;PST	succussed
Mediterraneanise	V;NFIN	Mediterraneanise
perfuse	V;PST	perfused
unpiece	V;V.PTCP;PST	unpieced
rattle	V;V.PTCP;PRS	rattling
prance	V;PST	pranced
mobilise	V;PST	mobilised
big	V;V.PTCP;PST	bigged
shoo	V;PRS;NOM-3;NOM-SG	shoos
glottalise	V;PST	glottalised
interjaculate	V;V.PTCP;PST	interjaculated
ambuscade	V;NFIN	ambuscade
predefine	V;V.PTCP;PRS	predefining
dethrone	V;PST	dethroned
imbody	V;NFIN	imbody
blore	V;V.PTCP;PST	blored
withstay	V;V.PTCP;PRS	withstaying
acetise	V;PRS;NOM-3;NOM-SG	acetises
nut	V;PST	nutted
hondel	V;PST	hondelled
prettyprint	V;PRS;NOM-3;NOM-SG	prettyprints
kit	V;NFIN	kit
deschool	V;V.PTCP;PRS	deschooling
resubject	V;PST	resubjected
haunt	V;NFIN	haunt
disparkle	V;NFIN	disparkle
revolutionalise	V;PRS;NOM-3;NOM-SG	revolutionalises
spawn	V;V.PTCP;PST	spawned
bedance	V;V.PTCP;PST	bedanced
imbrue	V;NFIN	imbrue
spawn	V;V.PTCP;PRS	spawning
chiv	V;NFIN	chiv
quintuplicate	V;V.PTCP;PST	quintuplicated
bladder	V;NFIN	bladder
otherize	V;NFIN	otherize
beyearn	V;NFIN	beyearn
refreeze	V;PRS;NOM-3;NOM-SG	refreezes
alphabetize	V;NFIN	alphabetize
discomfit	V;NFIN	discomfit
snuff	V;PST	snuffed
disapparate	V;PRS;NOM-3;NOM-SG	disapparates
celestify	V;V.PTCP;PRS	celestifying
pomade	V;PRS;NOM-3;NOM-SG	pomades
inbear	V;NFIN	inbear
wire	V;NFIN	wire
knick	V;PST	knicked
exulcerate	V;NFIN	exulcerate
supererogate	V;V.PTCP;PST	supererogated
expone	V;V.PTCP;PST	exponed
funnel	V;PST	funnelled
mistemper	V;PRS;NOM-3;NOM-SG	mistempers
ignify	V;V.PTCP;PRS	ignifying
biotreat	V;V.PTCP;PRS	biotreating
bobble	V;PRS;NOM-3;NOM-SG	bobbles
submerse	V;NFIN	submerse
overeye	V;V.PTCP;PRS	overeying
rewin	V;V.PTCP;PST	rewon
spill	V;PRS;NOM-3;NOM-SG	spills
ug	V;V.PTCP;PST	ugged
begink	V;V.PTCP;PST	beginked
dishonour	V;PST	dishonoured
jackhammer	V;V.PTCP;PST	jackhammered
tweedle	V;PRS;NOM-3;NOM-SG	tweedles
imbarn	V;NFIN	imbarn
out-winter	V;V.PTCP;PRS	out-wintering
yuk	V;PRS;NOM-3;NOM-SG	yuks
fortravel	V;NFIN	fortravel
phosphorate	V;PRS;NOM-3;NOM-SG	phosphorates
unbung	V;V.PTCP;PRS	unbunging
platten	V;PST	plattened
disvalue	V;PST	disvalued
screenwrite	V;V.PTCP;PST	screenwritten
haunt	V;V.PTCP;PRS	haunting
misgive	V;PST	misgave
forbeat	V;V.PTCP;PRS	forbeating
harrumph	V;PST	harrumphed
zerg	V;PST	zerged
geneticize	V;V.PTCP;PST	geneticized
asswage	V;V.PTCP;PST	asswaged
poop	V;V.PTCP;PRS	pooping
lyophilise	V;PST	lyophilised
recapitalise	V;V.PTCP;PRS	recapitalising
gob	V;PST	gobbed
enamour	V;NFIN	enamour
block	V;NFIN	block
disenvowel	V;NFIN	disenvowel
unpick	V;V.PTCP;PRS	unpicking
regain	V;V.PTCP;PRS	regaining
unsaddle	V;V.PTCP;PST	unsaddled
deorphanize	V;PST	deorphanized
wok	V;PRS;NOM-3;NOM-SG	woks
highlight	V;NFIN	highlight
respect	V;NFIN	respect
suicide	V;PRS;NOM-3;NOM-SG	suicides
disauthorize	V;V.PTCP;PRS	disauthorizing
deconfigure	V;V.PTCP;PRS	deconfiguring
decitizenize	V;V.PTCP;PRS	decitizenizing
reed	V;V.PTCP;PST	reeded
outscorn	V;V.PTCP;PST	outscorned
levy	V;V.PTCP;PRS	levying
polite	V;NFIN	polite
gang	V;PRS;NOM-3;NOM-SG	gangs
contextualise	V;NFIN	contextualise
exit	V;PST	exited
kosherize	V;PRS;NOM-3;NOM-SG	kosherizes
billow	V;NFIN	billow
coin	V;V.PTCP;PST	coined
forfare	V;NFIN	forfare
pink	V;V.PTCP;PST	pinked
memorialise	V;NFIN	memorialise
circummure	V;NFIN	circummure
emendate	V;NFIN	emendate
becue	V;NFIN	becue
bemulce	V;PRS;NOM-3;NOM-SG	bemulces
vroom	V;PST	vroomed
analyze	V;V.PTCP;PST	analyzed
autograft	V;V.PTCP;PST	autografted
shritch	V;PST	shritched
superhumanize	V;PST	superhumanized
mystify	V;V.PTCP;PRS	mystifying
implunge	V;NFIN	implunge
disvouch	V;V.PTCP;PRS	disvouching
chamfer	V;NFIN	chamfer
forban	V;V.PTCP;PRS	forbanning
four-flush	V;V.PTCP;PRS	four-flushing
remain	V;V.PTCP;PRS	remaining
pamp	V;NFIN	pamp
forthput	V;V.PTCP;PRS	forthputting
frivol	V;PST	frivolled
inglobe	V;PRS;NOM-3;NOM-SG	inglobes
resynch	V;PRS;NOM-3;NOM-SG	resynchs
tongue-lash	V;PST	tongue-lashed
unpunctuate	V;NFIN	unpunctuate
peripheralize	V;NFIN	peripheralize
fancy	V;PRS;NOM-3;NOM-SG	fancies
renavigate	V;V.PTCP;PST	renavigated
hard-boil	V;V.PTCP;PST	hard-boiled
misground	V;V.PTCP;PRS	misgrounding
signorise	V;V.PTCP;PRS	signorising
vehiculate	V;NFIN	vehiculate
conceive	V;PRS;NOM-3;NOM-SG	conceives
fecundate	V;PST	fecundated
breadboard	V;PRS;NOM-3;NOM-SG	breadboards
bedole	V;PST	bedoled
afford	V;V.PTCP;PRS	affording
Velcro	V;NFIN	Velcro
scald	V;PST	scalded
match	V;V.PTCP;PRS	matching
paste	V;V.PTCP;PST	pasted
unqualify	V;NFIN	unqualify
insensate	V;NFIN	insensate
ensheath	V;V.PTCP;PST	ensheathed
pleach	V;PRS;NOM-3;NOM-SG	pleaches
dindle	V;PRS;NOM-3;NOM-SG	dindles
descramble	V;PRS;NOM-3;NOM-SG	descrambles
asswage	V;V.PTCP;PRS	asswaging
affile	V;V.PTCP;PRS	affiling
pelt	V;V.PTCP;PRS	pelting
delouse	V;V.PTCP;PST	deloused
thumb	V;PST	thumbed
bequote	V;PST	bequoted
uncork	V;PRS;NOM-3;NOM-SG	uncorks
par	V;V.PTCP;PST	parred
gunk	V;PST	gunked
curtain	V;V.PTCP;PST	curtained
brew	V;V.PTCP;PST	brewed
ret	V;PRS;NOM-3;NOM-SG	rets
aerosolize	V;V.PTCP;PST	aerosolized
autorotate	V;PRS;NOM-3;NOM-SG	autorotates
taste	V;PST	tasted
besit	V;PST	besat
subspecialize	V;V.PTCP;PST	subspecialized
cume	V;V.PTCP;PRS	cuming
beblister	V;V.PTCP;PRS	beblistering
impawn	V;V.PTCP;PST	impawned
copyread	V;PRS;NOM-3;NOM-SG	copyreads
recentre	V;V.PTCP;PRS	recentring
carjack	V;NFIN	carjack
enamour	V;V.PTCP;PST	enamoured
aquaplane	V;V.PTCP;PST	aquaplaned
skimp	V;PST	skimped
custom	V;PRS;NOM-3;NOM-SG	customs
indenize	V;PRS;NOM-3;NOM-SG	indenizes
enfranchize	V;PRS;NOM-3;NOM-SG	enfranchizes
reingest	V;PRS;NOM-3;NOM-SG	reingests
peripheralize	V;PRS;NOM-3;NOM-SG	peripheralizes
misgrade	V;PST	misgraded
hypertextualize	V;PST	hypertextualized
hearken	V;V.PTCP;PST	hearkened
gelatinize	V;NFIN	gelatinize
gimlet	V;NFIN	gimlet
beshroud	V;NFIN	beshroud
uphaul	V;PST	uphauled
upwell	V;PST	upwelled
domineer	V;PST	domineered
nutcrack	V;NFIN	nutcrack
reaccredit	V;V.PTCP;PST	reaccredited
withstay	V;PST	withstayed
unbid	V;V.PTCP;PRS	unbidding
stridulate	V;NFIN	stridulate
omnify	V;PRS;NOM-3;NOM-SG	omnifies
tone	V;V.PTCP;PST	toned
prison	V;V.PTCP;PST	prisoned
teamkill	V;PST	teamkilled
envermeil	V;NFIN	envermeil
taper	V;PRS;NOM-3;NOM-SG	tapers
raff	V;V.PTCP;PRS	raffing
blat	V;PST	blatted
hurkle	V;PST	hurkled
blimp	V;V.PTCP;PST	blimped
grasp	V;PRS;NOM-3;NOM-SG	grasps
cheapen	V;NFIN	cheapen
dere	V;NFIN	dere
berm	V;PRS;NOM-3;NOM-SG	berms
eve	V;NFIN	eve
re-shoot	V;PST	re-shot
becover	V;V.PTCP;PST	becovered
belimb	V;PRS;NOM-3;NOM-SG	belimbs
carjack	V;V.PTCP;PRS	carjacking
splice	V;V.PTCP;PST	spliced
right-click	V;PST	right-clicked
slambang	V;PST	slambanged
overinflate	V;V.PTCP;PST	overinflated
chop	V;V.PTCP;PST	chopped
list	V;PST	list
banhammer	V;NFIN	banhammer
crosspost	V;PRS;NOM-3;NOM-SG	crossposts
suspend	V;V.PTCP;PRS	suspending
autocorrect	V;NFIN	autocorrect
refurbish	V;V.PTCP;PST	refurbished
cudgel	V;PRS;NOM-3;NOM-SG	cudgels
piggle	V;V.PTCP;PST	piggled
rehide	V;PRS;NOM-3;NOM-SG	rehides
antagonise	V;PRS;NOM-3;NOM-SG	antagonises
subselect	V;PST	subselected
imbarn	V;V.PTCP;PST	imbarned
carbonatize	V;PRS;NOM-3;NOM-SG	carbonatizes
gork	V;V.PTCP;PRS	gorking
minge	V;PRS;NOM-3;NOM-SG	minges
buycott	V;V.PTCP;PRS	buycotting
kalsomine	V;NFIN	kalsomine
autofit	V;V.PTCP;PST	autofitted
paum	V;PST	paumed
berhyme	V;V.PTCP;PRS	berhyming
heterograft	V;PRS;NOM-3;NOM-SG	heterografts
lixiviate	V;PST	lixiviated
curvet	V;NFIN	curvet
hem	V;PST	hemmed
parameterise	V;V.PTCP;PRS	parameterising
copay	V;V.PTCP;PRS	copaying
kit	V;PRS;NOM-3;NOM-SG	kits
cerebrate	V;V.PTCP;PRS	cerebrating
ram-raid	V;PST	ram-raided
gibbet	V;V.PTCP;PST	gibbetted
slingshot	V;V.PTCP;PRS	slingshotting
tölt	V;NFIN	tölt
spall	V;V.PTCP;PRS	spalling
pervert	V;PST	perverted
untangle	V;V.PTCP;PRS	untangling
scarify	V;PST	scarified
cock	V;PRS;NOM-3;NOM-SG	cocks
cure	V;V.PTCP;PST	cured
reinvestigate	V;PRS;NOM-3;NOM-SG	reinvestigates
submodify	V;NFIN	submodify
ump	V;PST	umped
unsaddle	V;V.PTCP;PRS	unsaddling
stoicize	V;PRS;NOM-3;NOM-SG	stoicizes
tamper	V;PRS;NOM-3;NOM-SG	tampers
assonate	V;V.PTCP;PRS	assonating
interlope	V;V.PTCP;PRS	interloping
detraditionalise	V;PST	detraditionalised
enwind	V;PRS;NOM-3;NOM-SG	enwinds
overlap	V;NFIN	overlap
perfuse	V;V.PTCP;PST	perfused
stoop	V;PRS;NOM-3;NOM-SG	stoops
migrate	V;V.PTCP;PRS	migrating
cherrypick	V;NFIN	cherrypick
preprovide	V;V.PTCP;PST	preprovided
nip	V;V.PTCP;PRS	nipping
crosscontaminate	V;PST	crosscontaminated
unground	V;V.PTCP;PST	ungrounded
bewarm	V;NFIN	bewarm
becast	V;PRS;NOM-3;NOM-SG	becasts
journey	V;NFIN	journey
syllabificate	V;NFIN	syllabificate
loathe	V;V.PTCP;PST	loathed
psychoanalyze	V;NFIN	psychoanalyze
jazz	V;PRS;NOM-3;NOM-SG	jazzes
manuscribe	V;PST	manuscribed
oil	V;V.PTCP;PST	oiled
immune	V;V.PTCP;PRS	immuning
mine	V;V.PTCP;PRS	mining
stoicize	V;PST	stoicized
slambang	V;PRS;NOM-3;NOM-SG	slambangs
acceed	V;PST	acceeded
succuss	V;V.PTCP;PRS	succussing
countersteer	V;NFIN	countersteer
depauperate	V;PST	depauperated
macadam	V;V.PTCP;PRS	macadamming
minge	V;V.PTCP;PST	minged
miscarry	V;PST	miscarried
unemploy	V;V.PTCP;PRS	unemploying
bite	V;V.PTCP;PRS	biting
render	V;PST	rendered
individuate	V;PST	individuated
satirize	V;V.PTCP;PST	satirized
replunge	V;V.PTCP;PST	replunged
overbalance	V;PRS;NOM-3;NOM-SG	overbalances
parbreak	V;V.PTCP;PST	parbreaked
bowel	V;V.PTCP;PRS	bowelling
unpick	V;NFIN	unpick
deasphalt	V;V.PTCP;PST	deasphalted
befriend	V;PST	befriended
submit	V;V.PTCP;PST	submitted
shit	V;V.PTCP;PST	shit
unheed	V;V.PTCP;PRS	unheeding
grave	V;PST	grove
unfool	V;V.PTCP;PST	unfooled
outshow	V;V.PTCP;PRS	outshowing
overinflate	V;PST	overinflated
poop	V;PST	pooped
lasso	V;V.PTCP;PST	lassoed
retouch	V;PRS;NOM-3;NOM-SG	retouches
wair	V;PRS;NOM-3;NOM-SG	wairs
mozy	V;NFIN	mozy
swattle	V;PST	swattled
soak	V;V.PTCP;PRS	soaking
disheart	V;V.PTCP;PRS	dishearting
assaile	V;PST	assailed
depacketize	V;NFIN	depacketize
gouge	V;NFIN	gouge
fold	V;PST	folded
uncentury	V;V.PTCP;PST	uncenturied
de-humanise	V;PST	de-humanised
conglaciate	V;V.PTCP;PST	conglaciated
presentiate	V;V.PTCP;PST	presentiated
begive	V;NFIN	begive
chop	V;PST	chopped
toe	V;PST	toed
hothouse	V;NFIN	hothouse
collodionize	V;NFIN	collodionize
excarnificate	V;PRS;NOM-3;NOM-SG	excarnificates
hiddle	V;V.PTCP;PST	hiddled
bewrinkle	V;NFIN	bewrinkle
underrotate	V;NFIN	underrotate
suffragate	V;V.PTCP;PRS	suffragating
brake	V;PRS;NOM-3;NOM-SG	brakes
block	V;V.PTCP;PST	blocked
finesse	V;PST	finessed
divertise	V;V.PTCP;PST	divertised
recapitulate	V;V.PTCP;PRS	recapitulating
amortize	V;V.PTCP;PRS	amortizing
upwell	V;NFIN	upwell
searce	V;PST	searced
inglobe	V;V.PTCP;PRS	inglobing
floss	V;V.PTCP;PST	flossed
wage	V;PRS;NOM-3;NOM-SG	wages
shortcut	V;PST	shortcutted
rasterize	V;V.PTCP;PST	rasterized
renominate	V;V.PTCP;PRS	renominating
overcriticize	V;V.PTCP;PST	overcriticized
tin	V;NFIN	tin
emprove	V;NFIN	emprove
scrab	V;PRS;NOM-3;NOM-SG	scrabs
block	V;V.PTCP;PRS	blocking
handplant	V;NFIN	handplant
predigest	V;V.PTCP;PRS	predigesting
erogate	V;PRS;NOM-3;NOM-SG	erogates
absent	V;V.PTCP;PRS	absenting
swattle	V;NFIN	swattle
parch	V;V.PTCP;PRS	parching
sporterize	V;PST	sporterized
secret	V;PRS;NOM-3;NOM-SG	secrets
bonnet	V;NFIN	bonnet
posit	V;V.PTCP;PST	posited
sparkle	V;V.PTCP;PST	sparkled
unmatch	V;PST	unmatched
untongue	V;V.PTCP;PST	untongued
ratoon	V;PST	ratooned
officialize	V;PRS;NOM-3;NOM-SG	officializes
